                                                                             
 |--------------------------|        |-----------------------|                       
 |..........................|        |.......................|                       
 |......|------------|......+########+.......................|-------|               
 |......|            |......|   #    |...............................|--|            
 |......|------------|......|   #    |..................................|--|         
 |---|..................|---|   #    |----+--|...|----+----|...............+######  
     |..................|     #############  |...|    #    |...............|     #  
     |------+-----------|     #     |-----+--|...|    #    |...............|     #  
            #                 #     |............|    #    |...............|     #  
            #                 #     |............|----+----|...............+######  
            #                 #     |......................................|         
            #                 #     |-----+----------+--------------+------|         
  |---------+-----------|     #           #          #              #                
  |.....................|     #           #          #         |----+------| 
  |.....................|     ########################         |...........|         
  |.....................|     #           #                    |...........|         
  |.....................|     #    |------+--------------------|...........|         
  |.....................|     #    |.......................................|         
  |.....................+##########+.......................................|         
  |.....................|          |.......................................|         
  |---------------------|          |---------------------------------------|         
                                                                             	
