                                                                             
 |--------------------------|        |-----------------------|               
 |..........................|        |.......................|               
 |..........................+########+.......................|-------|       
 |..........................|   #    |...............................|--|    
 |..........................|   #    |..................................|--| 
 |----------+---------------|   #    |----+----------------|...............| 
            #                 #############                |...............| 
            #                 #     |-----+------|         |...............| 
            #                 #     |............|         |...............| 
            ###################     |............|   ######+...............| 
            #                 #     |............|   #     |...............| 
            #                 #     |-----+------|   #     |--------+------| 
  |---------+-----------|     #           #          #              #        
  |.....................|     #           #          #         |----+------| 
  |.....................|     ########################         |...........| 
  |.....................|     #           #                    |...........| 
  |.....................|     #    |------+--------------------|...........| 
  |.....................|     #    |.......................................| 
  |.....................+##########+.......................................| 
  |.....................|          |.......................................| 
  |---------------------|          |---------------------------------------| 
                                                                             	
